NO ./textures/brick.xpm
SO ./textures/blue.xpm
WE ./textures/wood.xpm
EA ./textures/grey.xpm

S ./textures/chest.xpm
F 172,105,56
C 205,249,255

11111111111111111111
100100000000011111100111
101000000001111111111
1100N0000111
111111111111111111
